5 0  5 0  5 0  5 0  9 1  5 2  5 4  4 2  5 2  5 3  5 4  0 0  0 0  5 0  5 0  5 0  0 0  0 0  5 1  5 2 
5 0  5 0  5 0  5 0  9 1  9 2  5 2  5 2  5 2  3 2  3 1  5 0  5 0  5 0  5 0  5 0  0 0  0 0  5 1  5 2 
5 0  5 0  5 0  5 0  9 1  5 2  0 0  5 1  5 2  5 0  5 0  0 0  0 0  5 0  5 0  5 0  0 0  0 0  5 1  5 2 
5 2  5 2  5 2  5 0  5 0  0 0  0 0  5 1  5 2  5 0  5 0  0 0  0 0  5 0  5 0  5 0  0 0  0 0  5 1  5 2 
2 0  1 0  5 0  5 0  5 0  0 0  0 0  5 1  5 2  5 0  5 0  0 0  0 0  5 0  5 0  5 0  0 0  0 0  5 1  5 2 
3 0  0 0  5 0  5 0  5 0  0 0  0 0  5 1  5 2  5 0  5 0  0 0  0 0  5 0  5 0  5 0  0 0  0 0  5 1  5 2 
4 0  0 0  5 0  5 0  5 0  0 0  0 0  5 1  5 2  5 0  5 0  0 0  0 0  5 0  5 0  5 0  0 0  0 0  5 1  5 2 
6 0  0 0  5 0  5 0  5 3  0 0  0 0  5 1  5 2  5 0  5 0  0 0  0 0  5 0  5 0  5 0  0 0  0 0  5 1  5 2
7 0  0 0  5 0  5 0  5 3  0 0  0 0  5 1  5 2  5 0  5 0  0 0  0 0  5 0  5 0  5 0  0 0  0 0  5 1  5 2 
8 0  0 0  5 0  5 0  5 0  0 0  0 0  5 1  5 2  5 0  5 0  0 0  0 0  5 0  5 0  5 0  0 0  0 0  5 2  5 2 
9 0  0 0  5 0  5 0  5 0  0 0  5 0  5 1  5 2  5 0  5 0  0 0  0 0  5 0  5 0  5 0  0 0  0 0  5 1  5 2
0 0  5 0  5 0  5 0  5 0  5 0  5 0  5 0  5 0  5 0  5 0  5 0  5 0  5 0  5 0  5 0  5 0  5 0  9 1  9 2
0 0  0 0  5 0  4 1  5 0  0 0  5 0  5 1  5 2  5 0  5 0  0 0  0 0  5 0  5 0  5 0  0 0  9 0  5 2  5 2 
0 0  0 0  5 0  5 1  5 0  0 0  0 0  5 1  5 2  5 0  5 0  0 0  0 0  5 0  5 0  5 0  0 0  9 0  5 2  5 2
0 0  0 0  5 0  7 2  5 0  0 0  0 0  5 1  5 2  5 2  5 2  5 2  9 3  5 3  3 3  5 2  5 2  5 2  5 2  5 2 
0 0  0 0  5 0  5 2  5 0  0 0  0 0  5 1  5 2  5 0  5 0  0 0  0 0  5 0  5 0  5 0  9 1  9 2  5 2  5 2 
0 0  0 0  5 0  6 3  5 0  0 0  0 0  5 1  5 2  5 0  5 0  0 0  0 0  5 0  5 0  5 0  9 1  9 2  5 2  5 2 
0 0  0 0  5 0  5 3  5 3  5 3  3 3  5 2  5 2  5 0  5 0  0 0  0 0  5 0  5 0  5 0  9 1  9 2  5 2  5 2 
0 0  0 0  5 0  5 3  5 0  9 1  9 2  5 2  5 2  5 0  5 0  0 0  0 0  5 0  5 0  5 0  9 1  9 2  5 2  5 2 
0 0  0 0  5 0  5 0  5 0  9 1  9 2  5 2  5 2  5 0  5 0  0 0  0 0  5 0  5 0  5 0  9 1  9 2  5 2  5 2

0 0
19 19 19 18 18 19 18 18 17 19 17 18
