5 0  5 0  5 0  5 0  9 1  5 2  5 4  4 2  5 2  5 3  5 4  0 0  0 0  5 0  5 0  5 0  0 0  0 0  5 1  5 2 
5 0  5 0  5 0  5 0  9 1  5 2  5 2  5 1  5 2  5 0  5 0  0 0  0 0  5 0  5 0  5 0  0 0  0 0  5 1  5 2 
5 0  5 0  5 0  5 0  9 1  5 2  0 0  5 1  5 2  5 0  5 0  0 0  0 0  5 0  5 0  5 0  0 0  0 0  5 1  5 2 
5 2  5 2  5 2  5 0  5 0  0 0  0 0  5 1  5 2  5 0  5 0  0 0  0 0  5 0  5 0  5 0  0 0  0 0  5 1  5 2 
2 0  1 0  5 0  5 0  5 0  0 0  0 0  5 1  5 2  5 0  5 0  0 0  0 0  5 0  5 0  5 0  0 0  0 0  5 1  5 2 
0 0  0 0  5 0  5 0  5 0  0 0  0 0  5 1  5 2  5 0  5 0  0 0  0 0  5 0  5 0  5 0  0 0  0 0  5 1  5 2 
0 0  0 0  5 0  5 0  5 0  0 0  0 0  5 1  5 2  5 0  5 0  0 0  0 0  5 0  5 0  5 0  0 0  0 0  5 1  5 2 
0 0  0 0  5 0  5 0  5 0  0 0  0 0  5 1  5 2  5 0  5 0  0 0  0 0  5 0  5 0  5 0  0 0  0 0  5 1  5 2
0 0  0 0  5 0  5 0  5 0  0 0  0 0  5 1  5 2  5 0  5 0  0 0  0 0  5 0  5 0  5 0  0 0  0 0  5 1  5 2 
0 0  0 0  5 0  5 0  5 0  0 0  0 0  5 1  5 2  5 0  5 0  0 0  0 0  5 0  5 0  5 0  0 0  0 0  5 1  5 2 
0 0  0 0  5 0  5 0  5 0  0 0  0 0  5 1  5 2  5 0  5 0  0 0  0 0  5 0  5 0  5 0  0 0  0 0  5 1  5 2
0 0  0 0  5 0  5 0  5 0  0 0  0 0  5 1  5 2  5 0  5 0  0 0  0 0  5 0  5 0  5 0  0 0  0 0  5 1  5 2
0 0  0 0  5 0  5 0  5 0  0 0  0 0  5 1  5 2  5 0  5 0  0 0  0 0  5 0  5 0  5 0  0 0  0 0  5 1  5 2 
0 0  0 0  5 0  5 0  5 0  0 0  0 0  5 1  5 2  5 0  5 0  0 0  0 0  5 0  5 0  5 0  0 0  0 0  5 1  5 2
0 0  0 0  5 0  5 0  5 0  0 0  0 0  5 1  5 2  5 0  5 0  0 0  0 0  5 0  5 0  5 0  0 0  0 0  5 1  5 2 
0 0  0 0  5 0  5 0  5 0  0 0  0 0  5 1  5 2  5 0  5 0  0 0  0 0  5 0  5 0  5 0  0 0  0 0  5 1  5 2 
0 0  0 0  5 0  5 0  5 0  0 0  0 0  5 1  5 2  5 0  5 0  0 0  0 0  5 0  5 0  5 0  0 0  0 0  5 1  5 2 
0 0  0 0  5 0  5 0  5 0  0 0  0 0  5 1  5 2  5 0  5 0  0 0  0 0  5 0  5 0  5 0  0 0  0 0  5 1  5 2 
0 0  0 0  5 0  5 0  5 0  9 1  9 2  5 2  5 2  5 0  5 0  0 0  0 0  5 0  5 0  5 0  0 0  0 0  5 1  5 2 
0 0  0 0  5 0  5 0  5 0  9 1  9 2  5 2  5 2  5 0  5 0  0 0  0 0  5 0  5 0  5 0  0 0  0 0  5 1  5 2
